a	humans/girls.txt	1
a	animals/cats.txt	2
a	animals/rabbits.txt	1
a	animals/dogs.txt	3
a	tech/computers.txt	1
about	animals/rabbits.txt	1
almost	tech/computers.txt	1
ambitious	humans/girls.txt	1
and	humans/girls.txt	1
and	animals/cats.txt	1
and	animals/dogs.txt	1
another	humans/girls.txt	1
another	animals/rabbits.txt	1
are	animals/rabbits.txt	1
are	humans/girls.txt	1
are	animals/dogs.txt	1
are	tech/computers.txt	1
are	animals/cats.txt	2
awesome	animals/dogs.txt	1
best	animals/dogs.txt	1
can	animals/dogs.txt	1
cat	animals/cats.txt	2
cats	animals/cats.txt	2
come	humans/girls.txt	1
computation	tech/computers.txt	1
computers	tech/computers.txt	3
computing	tech/computers.txt	1
cute	animals/rabbits.txt	1
day	tech/computers.txt	1
dog	animals/dogs.txt	1
dogs	animals/dogs.txt	5
each	animals/rabbits.txt	1
egypt	animals/cats.txt	1
even	animals/rabbits.txt	1
every	tech/computers.txt	1
everybody	animals/dogs.txt	1
friend	animals/dogs.txt	1
girl	humans/girls.txt	2
girls	humans/girls.txt	2
high	animals/dogs.txt	1
important	animals/cats.txt	1
in	animals/cats.txt	1
interesting	humans/girls.txt	2
is	animals/dogs.txt	1
is	animals/rabbits.txt	1
is	animals/cats.txt	1
jump	animals/dogs.txt	1
keep	humans/girls.txt	1
like	animals/cats.txt	1
looks	humans/girls.txt	1
lot	tech/computers.txt	1
love	animals/dogs.txt	2
love	animals/cats.txt	1
love	animals/rabbits.txt	1
lovers	animals/cats.txt	1
make	animals/rabbits.txt	1
man	animals/dogs.txt	1
many	humans/girls.txt	1
may	animals/rabbits.txt	1
more	animals/rabbits.txt	1
nice	animals/cats.txt	1
of	animals/cats.txt	1
of	animals/dogs.txt	1
of	tech/computers.txt	2
onto	humans/girls.txt	1
other	animals/dogs.txt	1
other	animals/rabbits.txt	1
people	animals/cats.txt	2
powerful	tech/computers.txt	1
prefer	humans/girls.txt	1
rabbit	animals/rabbits.txt	2
rabbits	animals/rabbits.txt	4
run	animals/rabbits.txt	1
secrets	humans/girls.txt	1
shy	humans/girls.txt	1
something	animals/cats.txt	1
strangely	humans/girls.txt	1
symbol	animals/cats.txt	1
text	animals/rabbits.txt	1
them	animals/cats.txt	1
there	animals/cats.txt	1
they	humans/girls.txt	1
things	tech/computers.txt	1
this	animals/rabbits.txt	1
to	animals/rabbits.txt	2
to	tech/computers.txt	1
to	humans/girls.txt	1
towards	tech/computers.txt	1
use	tech/computers.txt	1
very	tech/computers.txt	1
very	animals/cats.txt	1
very	humans/girls.txt	1
way	tech/computers.txt	1
we	tech/computers.txt	1
when	animals/cats.txt	1
with	humans/girls.txt	1
work	tech/computers.txt	1
